NO ./assets/red.xpm     

SO                ./assets/greystone.xpm   

WE ./assets/eagle.xpm
EA ./assets/purplestone.xpm            




F 100,100,7


C            250,30,0    



        1111111111111111111111111
        1000000000110000000000001
        1011000001110000000000001
        1001000000000000000000001  
111111111011000001110000000000001  
100000000011000001110111110111111
11110111111111011100000010001
11110111111111011101010010001
11000000110101011100000000001     1111111111
10000000000000001100000010001     1000000001                                               
10000000000000001101010010001      111111111
1100000111010101 11101111000111
11110111 1110101 101111010001
11111111 1111111 111111111111
1111
10W1
1111        